1 5
#####
#   #
#@$.#
# $.#
#####