1
########
# @    #
# .  $ #
#      #
########
