14 77 1
 #####
 #   ####
 #   #  #
 ##    .#
### ###.#
# $ # #.#
# $$# ###
#@  #
#####