6 9 
  #######
###.    #
#   $ $ #
#@  #.###
########