1 5 10
########
#  ... #
#  #$# #
#  $ # #
#  # # #
#   $ @#
#      #
########