40 50
###########
#         #
#   $  ## #
#      #  #
#    ######
#      #. #
#         #
# @  #    #
#####  $  #
# .       #
###########