1 99
#########
#@      #
# $   $ #
#### ####
#       #
#     . #
# .     #
#########