1 10 99
########
#@     #
#  $$$ #
#      ###
###      #
#        #
# # ###  #
#...     #
##########