1 99
########
#      #
#@$$   #
#.    .#
########